11111111111111111111111111
10P00000000000000000000E01
10000000000000000000000001
10111011101110111101011101
1010001C001010100001010101
10111011101110101101010101
100C10100011C0100101010101
10111011101C10111101011101
10C00000000000000000000C01
10000000000000000000000001
11111111111111111111111111