11111111111111
10000000000001
100000000P0001
1000C000000001
1000000E000001
10000000000001
11111111111111