11111111111111
1P0111111110C1
11001000010011
11100000000111
11001000E10011
1C0111111110C1
11111111111111