11111111111111
10000000000001
1000000000P001
100C0000000001
1000000E000001
1000C000000001
11111111111111