11111111111111111111111111
11P11111111111111111111E11
11111111111111111111111111
11000100010001000010100011
11011101110101011110101011
11000100010001010010101011
11110101110011011010101011
11000100010101000010100011
11C11111111111111111111C11
11111111111111111111111111
11111111111111111111111111